1111111111111111111111111111
1P00001000011111110010001C01
1000100000001111100010001001
1010101000000111000011111001
1001001000000010000000100001
101010C0000100000000001C0001
1000100000000010100000101001
1100010C000C0000100000000001
110101E010000110000000001001
1001001000110000000010000001
100100111000000001000001C001
1001001001001100100000C00001
1001001000011000C00010001001
1111111111111111111111111111