1111111111
10C0001011
1000100011
1010101001
1001001001
101010C101
1000100001
1100010C01
110101E011
1111111111
