1111111111
1000001011
1000100011
1010101001
1001001001
1010100101
1000100001
1100010001
110101E011
1111111111
