111111111111111111111
1P0001111100010001C01
1000C1111100010001001
101000111000001100001
10100001000000C100001
1000100000000000C1111
10100001010C000100CE1
111111111111111111111