111111111111111111111
1P0001111100010001C01
1000C1111100010001001
101000111000001110001
10100001000000C100001
1000100000000000C0001
10100001010C0001010E1
111111111111111111111