111111111111111111111
1P0001111100010001C01
1000C11C1100010001001
101000111000001110001
10100001000000C100001
10100000010C0000010E1
111111111111111111111